cells-horizontal 14
cells-vertical 15
cell-width 5
cell-height 3
color yellow
path 4,0;4,13;10,13;10,4;13,4
OOOOXOOOOOOOOO
OOOOXOOOOOOOOO
OOOOXOOOOOOOOO
OOOOXOOOOOOOOO
OOOOXOOOOOXXXX
OOOOXOOOOOXOOO
OOOOXOOOOOXOOO
OOOOXOOOOOXOOO
OOOOXOOOOOXOOO
OOOOXOOOOOXOOO
OOOOXOOOOOXOOO
OOOOXOOOOOXOOO
OOOOXOOOOOXOOO
OOOOXXXXXXXOOO
OOOOOOOOOOOOOO
end
....................|   |.............................................
....................|   |.............................................
....................|   |.............................................
....................|   |.............................................
....................|   |.............................................
....................|   |.............................................
....................|   |.............................................
....................|   |.............................................
....................|   |.............................................
....................|   |.............................................
....................|   |.............................................
....................|   |.............................................
....................|   |.........................|-------------------
....................|   |.........................|                   
....................|   |.........................|   ----------------
....................|   |.........................|   |...............
....................|   |.........................|   |...............
....................|   |.........................|   |...............
....................|   |.........................|   |...............
....................|   |.........................|   |...............
....................|   |.........................|   |...............
....................|   |.........................|   |...............
....................|   |.........................|   |...............
....................|   |.........................|   |...............
....................|   |.........................|   |...............
....................|   |.........................|   |...............
....................|   |.........................|   |...............
....................|   |.........................|   |...............
....................|   |.........................|   |...............
....................|   |.........................|   |...............
....................|   |.........................|   |...............
....................|   |.........................|   |...............
....................|   |.........................|   |...............
....................|   |.........................|   |...............
....................|   |.........................|   |...............
....................|   |.........................|   |...............
....................|   |.........................|   |...............
....................|   |.........................|   |...............
....................|   |.........................|   |...............
....................|   ---------------------------   |...............
....................|                                 |...............
....................|---------------------------------|...............
......................................................................
......................................................................
......................................................................
end
eof
